 -:::-:::::::::::::::::-::::::::::::::::-::::::::-:::::::::::::::::-::::::::::::-:::::::- 
 =-=-=                 =                =        =                .:           .-       :.
 = . -    ::::.   .    =   .::::::::.   -        -   .:::::::::   .:   .   .   .-   .   :.
 =        =   -   =    =            =        :       -.       =        =   -   .-   =   :.
 =        =   -   =    =            +        -       -:       =        =   -   :-   =   -.
 =        =       =    =       .:   +            =   -:       =            -            -.
 =        =       =    =       .:   =            =   -.       =            -            :.
 +:::+::::::::=    ::::=   =::::::::+   =::::    =   -.   *:::.   .:   =::::   .=:::.   :.
 =   =        -        =   =        =   =        =   -.   =       .:   =       .-       :.
 =   =    =:::-::::    =   :::::    =   =    -:::-:::-    =   -:::-=::::   :::::-:::::::=.
 =   =    =            =            =   =    :            =   =   .:       -            :.
 =   :    :   .    ::::-::::::::.   =   =    .   :    ::::=   :   .:   .:::-    .   :   :.
 =            -                .:   =   =        =        =       .:           .-   =   :.
 +::::::::.   =:::::::::::::   .:   =   -::::::::=::::    =   .:::-=:::.   .:::-:   =   :.
 =        =   -            =   .:   =        :       -.   =       .:       -        =   :.
 =    ....=   -    ....    =   .:   +....    -....   -:...+....   .:   ....=        =   :.
 =   =        -        =       .:       =    -       -:       =   .:       -   .-   =   :.
 =   =        -        =       :-       =    :       -.       =   .-       -   .-   =   :.
 =   =....    ....+    +...+.........   =        =   -.   =   =   .-.......=   .=....   :.
 =   =            =    =   =            =        =   -.   =   =   .:       -   .-       :.
 =   .    =:::.   =    .   =    :::::::::    =:::=   .::::.   =    .   -   .   .-   .:::=.
 =        =       =        =                 :   =            =        =       .-       :.
 +::::::::=   ::::-::::::::-::::::::=::::::::.   =   :::::::::+::::    =:::-::::-:::.   :.
 =        =   -                     =            =   -.       =        =   -            :.
 =   .    -   -   .::::::::-::::.   =::::::::.   -   --:::.   =    ::::-   :    .   .:::=.
 =   =        -   =        =   .:            :       -.       =   .:           .-       :.
 =   =    ::::=   =        =   .=::::::::    :       -.   ::::+   .=::::::::   .=:::.   :.
 =   =    =       =    =       .:   =            =   -.   =       .:           .-       :.
 =   =....=    ...+    +.......::   =    ........=   -.   =    ...::        ...:=.......-.
 =        =       =            ::       =        =   -.       =        =       :-       -.
 =        =       =            .:       =        =   -.       =        =       .-       :.
 +:::+    .   -   =::::::::=    ::::+::::    :   .:::=-::::::::   .=:::+::::   .-   -   :.
 =   =        -   =        =        =        :       -.           .:   =       .-   =   :.
 =   =:::::::::   =    -   :::::    =   -::::::::-   .    =::::::::.   =    :::--   ::::=.
 =   =            =    =            =   =        =        =            =       .-       :.
 =   =    :::::   =    =:::-::::::::+   =    ::::=::::::::=   :    ::::+:::-    -::::   :.
 =   =        -   =        =        =   =                 =   =        =   -        =   :.
 =   -::::.   =:::+::::.   =        =   =    :::::::::    =   =::::    -   -::::    =   :.
 =        =   -        =   =   .:   =   =        =   -.       =            -        =   :.
 =....    =   -        =   =   .-...+   =        =   -:.......=    .....   -    ....=   :.
 =        =       =        =        =        :            =       .:       -        =   :.
 =        =       =        =        =        :            =       .:       -        =   :.
 =    ::::::::.    ::::::::::::-:   .:::::::::::::::::    =   .:::-:   .:::::::--    .=--.
 =                             .:                         =       .:           .-    =%#=.