| |||||||||||||||||||
| |             | |||
| | || |||||||| |   |
| |  | || |     ||| |
| || |    | ||||||| |
| |||| ||||       | |
| |       ||||||| | |
| | ||||| ||||||  | |
| |    || ||   | |  |
| | || || || | | || |
| | ||||| || | |    |
| | |   |    | ||||||
|   | | | |||| ||||||
||||| | | ||||      |
|  || | ||||||||||| |
|| || |           | |
|| || ||||||||||| | |
|   | |        || | |
| ||| || ||||| || | |
|        |     ||   |
|||||||||| ||||||||||


