###################################################################################################
#                                                                           ?                     #
#############################   #####################################  ############################
#                                                                   #  #                          #
#                                                                   # ?#                          #
#####################################################################  ############################
#                                                                                                 #
#########################################  ##########################  ############################
#                                       #  #                                                      #
#                                       # ?#                                                      #
#########################################  ########################################################
#                                                                                                 #
##################################  ###############################################################
#                                                                                                 #
#                                                                                                 #
#################################   ###########################  ##################################
#                                                             #                                   #
#                                                             #  #                                #
###############################################################  ##################################
#                                                                           ?                     #
###############################################################  ##################################
###############################################################  ##################################
###############################################################  ##################################
###############################################################  ##################################
######################################                                                   ##########
###############################################################  ######################  ##########
###############################################################  ######################  ##########
#######################################                                !                 ##########
#######################################  ##########################################################
#######################################  ######################  ##################################
#######################################  ######################  ##################################
#######################################  ######################  ##################################
#######################################  ######################  ##################################
#######################################  ######################  ##################################
#######################################  ######################  ##################################
#######################################  ######################  ##################################
#                              !                                                                  #
###############################################################  ##################################
#                                                                                          !      S
###################################################################################################