###################################################################################################
#                                                                                            ?    #
#####################################################################   ###########################
#                                                                   #   #                         #
#                                                                   #   #                         #
#                                                                   #   #                         #
#                        ?                                              #                         #
#                                                                   #   #                         #
#                                                                   #   #                         #
#                                                                   #                             #
#                                                                   #                             #
#####################################################################   ###########################
#                                                                   #   #                         #
#                                                                   #   #                         #
#                                                                   #   #                         #
#                                                                                                 #
#                                                                                                 #
#                                                                   #   #                         #
#                                                                   #   #                      ?  #
#                                                                   #   #                         #
#####################################################################   ###########################
#                                                                                                 #
#                                                                                                 #
#####################################################################   ###########################
#                                                                   #   #                         #
#                                                     !             #   #                         #
#                                                                   #   #                         #
#                                                                       #                         #
#                                                                   #   #                         #
#                                                                   #   #                         #
#                                                                   #                             #
#                                                                   #                             S
#####################################################################   ###########################
#                                                                   #   ###########################
#                                                                   #   ###########################
#                                                                   #   ###########################
#                                                                   #   ###########################
#                !                                                  #   ###########################
#                                                                                                 #
###################################################################################################