###################################################################################################
#                                                                                    ##############
###  ############################################################################  #######  ?   ###
###  ##############################                                                #######  ##  ###
###  #########            #########  ############################################  #######  ##  ###
###  #########  ########  #########  ############################################           ##  ###
###  #########  ###  ###  #########  ############                 ##################  ########  ###
###      ?      ###  ###  #########  ############  #############  ##################  ########  ###
###################  ###  #########  ############  #############  ##################  ########  ###
###################  ###             ############  #############  ##################  ########  ###
###################  ############################  ############                       ########  ###
##        #########  ############################  ###########################################  ###
##  ####  #########                                ###########################################  ###
##  ####  ###########################  #######################################################  ###
##  ####  ###########################  #####                                             #####  ###
##  ####  #########                    #####  #########################################  #####  ###
##  ####  ###########################  #####  #####   ?        ########################  #####  ###
##  ####  ###########################  #####  #####  ########  ###############           #####  ###
##  ####                               #####  #####  ########  ###############  #######  #####  ###
##  #################################  #####         ########  ###############  #######  #####  ###
##  #################################  ######################  ###############  #######  #####  ###
##  #################################                          ###############  #######         ###
##  #################################  ###########################              ###################
##                     ##############  ######                       ###############################
#####################  ##############  ######  ####################################################
#####################  ##############  ######                                    ##################
#####################  ##############  ########################################  ##################
## !    #############  ##############  ########################################  ##################
######  #############  ##############  ########################################                  ##
######                                                #########################  ##################
############  ######################################  #########################  ##################
############  ######################################                             ##################
############  ######################################  ##############  #############################
############  ########                   ###########  ##############  #############################
############  ########  ###############  ###########  ##############  ###########            ######
####          ########  ###############  ###########  ##############  ###########  ########  ######
####  ################  ###############  ###########  ##############  ###########  ########  ######
####  ################  ###############  ###########  ##############               ########  ######
####                    ###############       !       #####################################       S
###################################################################################################