*                                                      
 *
*  .   :..........:.......:.....................:....  
 *
*  .   :          :       :                     :   .  
 *
*  .   :   :....  .   .   :   :...............  .   .  
 *
*  .   :   :   :      :   :   :              :      .  
 *
*  .   :   :   :......:   :   :...........   :...   .  
 *
*  .   :   :              :      :       :          .  
 *
*  .   :   :              :      :       :          .  
 *
*  .       :   ...............:      :   :......-   .  
 *
*  .       :                  :      :   :      :   .  
 *
*  ........:...............   -.......   :   .  .....  
 *
*  .                      :   :          :   :      .  
 *
*  .   .   ............   :   :  ........:   -...   .  
 *
*  .   :              :   :   :  :           :  :   .  
 *
*  .   :..........    :   :   :  :    .......:  :   .  
 *
*  .    ..........:   :   :   :       .......   :   .  
 *
*  .              :   :   :   :                 :   .  
 *
*  ............:...   :   :   :  ....:........  :   .  
 *
*  .           :      :   :   :  :   :       :  :   .  
 *
*  .    ....   :  .   :....   :  .   :   .   :..:   .  
 *
*  .       :   :  :   :       :      :   :          .  
 *
*  .....   :   :  :   :   ....-...   :   :.......   .  
 *
*  .       :      :   :   :      :   :       :      .  
 *
*  .       :      :   :   :      :   :       :      .  
 *
*  .    ..............:   :   .   .......:   :   ....  
 *
*  .                  :   :   :          :   :      .  
 *
*  .    ...:......:   :   :   :..:....   :   :.......  
 *
*  .       :      :   :   :      :       :          .  
 *
*  .....   :...   :   :   :...   :    ...:.......   .  
 *
*  .              :              :                     
 *
*  .              :              :                     
 *
*   ............................................       
 *
*                                                      
 *
